%%%%%%%%%%%
%S        %
%         %
%    A    %
%         %
%        S%
%%%%%%%%%%%
